111111
100001
100001
100001
1CEP01
111111