111111111111
1C10C00010E1
101111101001
101000001111
101111110111
1P00000000C1
111111111111