111111111111
1C10C00010C1
101111101001
10100000E111
101111110111
1P00000000C1
111111111111