111111111111
1C1EC0001111
101111101111
101000001111
101111100111
1P00000000P1
111111111111