111111111111
101E00001111
101111101111
101000001111
101111100111
1P0000000001
111111111111