111111111111
1C10C0001111
101111101111
101000001111
101111100111
1P0000000001
111111111111