111111111111111111111111111111111111111111111
1000000000000000000000CPE00000000000000000001
111111111111111111111111111111111111111111111
100000000000000000000000000000000000000000001
111111111111111111111111111111111111111111111
100000000000000000000000000000000000000000001
111111111111111111111111111111111111111111111
100000000000000000000000000000000000000000001
111111111111111111111111111111111111111111111
100000000000000000000000000000000000000000001
111111111111111111111111111111111111111111111
100000000000000000000000000000000000000000001
111111111111111111111111111111111111111111111
100000000000000000000000000000000000000000001
111111111111111111111111111111111111111111111
100000000000000000000000000000000000000000001
111111111111111111111111111111111111111111111
100000000000000000000000000000000000000000001
111111111111111111111111111111111111111111111
100000000000000000000000000000000000000000001
111111111111111111111111111111111111111111111
100000000000000000000000000000000000000000001
100000000000000000000000000000000000000000001
100000000000000000000000000000000000000000001
111111111111111111111111111111111111111111111