1111111111111111111111111111111111111111111111111111111111111111111111111111
1000000000C000000000000P0000000E00000000000000000000000000000000000111111111
1000000000000000000000000000000000000000000000000000000000000000000111111111
1000000000000000000000000000000000000000000000000000000000000000000111111111
1000000000000000000000000000000000000000000000000000000000000000001111111111
1000000000000000000000000000000000000000000000000000000000000000001111111111
1000000000000000000000000000000000000000000000000000000000000000001111111111
1000000000000000000000000000000000000000000000000000000000000000001111111111
1000000000000000000000000000000000000000000000000000000000000000001111111111
1000000000000000000000000000000000000000000000000000000000000000001111111111
1000000000000000000000000000000000000000000000000000000000000000001111111111
1000000000000000000000000000000000000000000000000000000000000000011111111111
1000000000000000000000000000000000000000000000000000000000000000011111111111
1000000000000000000000000000000000000000000000000000000000000011111111101111
1000000000000000000000000000000000000000000000000000000000000011111111111111
1000000000000000000000000000000000000000000000000000000000000001111111111111
1000000000000000000000000000000000000000000000000000000000000000001111111111
1000000000000000000000000000000000000000000000000000000000000000001111111111
1000000000000000000000000000000000000000000000000000000000000011111111111111
1000000000000000000000000000000000000000000000000000000000000011111111111111
1000000000000000000000000000000000000000000000000000000000000011111111111111
1000000000000000000000000000000000000000000000000000000000000011111111111111
1111111111111111111111111111111111111111111111111111111111111111111111111111
1111111111111111111111111111111111111111111111111111111111111111111111111111
1000000000000000000000000000000000000000000000000000000000000000000111111111
1000000000000000000000000000000000000000000000000000000000000000000111111111
1000000000000000000000000000000000000000000000000000000000000000001111111111
1000000000000000000000000000000000000000000000000000000000000000001111111111
1000000000000000000000000000000000000000000000000000000000000000001111111111
1000000000000000000000000000000000000000000000000000000000000000001111111111
1000000000000000000000000000000000000000000000000000000000000000001111111111
1000000000000000000000000000000000000000000000000000000000000000001111111111
1000000000000000000000000000000000000000000000000000000000000000001111111111
1000000000000000000000000000000000000000000000000000000000000000011111111111
1000000000000000000000000000000000000000000000000000000000000000011111111111
1000000000000000000000000000000000000000000000000000000000000011111111101111
1000000000000000000000000000000000000000000000000000000000000011111111111111
1000000000000000000000000000000000000000000000000000000000000001111111111111
1000000000000000000000000000000000000000000000000000000000000000001111111111
1000000000000000000000000000000000000000000000000000000000000000001111111111
1111111111111111111111111111111111111111111111111111111111111111111111111111