111111111111111111111111111
100000CCCCC0000000000000011
10C000111111111100010000001
10C0001000P0000100110000011
10000010C00CC001000C1000011
10000011000000000000100A001
10000100CCCC000000001100011
1000000111111E1111110000011
111100000000000000000000011
111111111111111111111111111