111111111111111111111111111
100000CCCCC0000000000000011
10C00P100000000000100000011
10C000100000000000110000011
10000000C00CC000000C1000011
100000C00000000000010000011
10000100CCCC000000001100011
1000000111111E1111110000011
111100000000000000000000011
111111111111111111111111111