11111111111111111111111111
100000CCCCC000000000000001
10C00010000000000010000001
10P00010000000000011000001
10000000C00CC000000C100001
100000C0000000000001000001
10000100CCCC00000000110001
1000000111111E111111000001
11110000000000000000000001
11111111111111111111111111